XXXXXXXX
X S    X
X XXXX X
X X G  X
XXXXXXXX
